000011100011000
000000000000000
000000000000111
000000000011111
000111000000000
110000000000110
000000000011100
110000000000000
000000000000000
011111000000000
000000000001111
000000000000000
111000000000011
111110000000000
000000000000000
000000111000000
000000000000000
000000000000000
111000000000000
000000011000000