000000000011000
000000000000000
000000000000000
000001100000000
000000000000010
000000000000010
000000000000010
110000000000000
000000110000000
000000110000000
000000110001100
000000000000000
000000000000000
011000000000000
011000000000000
001000011000000
000000000000000
000000000000000
111000000000000
000000011000000