000011100011000
000000000000000
000000000000111
000000000000111
000000000000000
000000000000000
000000000000000
110000000000000
000000110000000
000000110000000
000000110001111
000000000000000
000000000000011
111100000000000
000000000000000
000000011000000
000000000000000
000000000000000
111000000000000
000000011000000